IPA symbol: Sample usage
(categorization credit to http://www.phon.ucl.ac.uk/home/wells/ipa-unicode.htm)

 : hu, u
': 'plent.ɨn
(: ˈg(w)ri(z)jɛn
): ˈg(w)ri(z)jɛn
*: *gune̞ː
,: hu, u
-: gɑ̃n-t
.: ˈtʃi.lɪk
/: ˈbeːzã en e ˈxurves/ˈbeːzã gurˈveːzet
:: ma:, mah
;: əmb, əm; amb, am; en
=: kʰɑni=ʋor
?: o:a (?), ai
X: XXX
~: i ~ j-
·: að·a:ɣəθər

a: ɡ̊ʲaɫ̪
e: d̊ʲeː
i: ˈfʲiəkəlʲ
o: koː
u: flux
y: ˈryː, ˈryːz
á: nákti
â: ˈprâti
ã: mãːhɪɾʲ
æ: ˈfˠæɾˠɟɪ
é: teʔe, té, te
ê: ˈtêtɕi
ì: léì̯os
í: oi̯kíaː
î: ˈbrîsati
ó: ompʰalós
ô: ˈkôntaṽ, ˈkuntaṽ
õ: kõ
ø: ˈløːn
ù: entáù̯tʰa
ú: lúːɔː
û: ʒûːt
ā: pādarō
ē: orpēs
ě: ˈtʃětiri
ĩ: kɐ̃ĩ
ī: əsī̃
ĭ: vaĭp
ō: chōkir-
œ: ˈblœ̃wɛn, ˈblœ̃niɛn
ũ: bɐʃˈtɐ̃ũ
ŭ: fraŭ
ǎ: ˈbǎːtsiti
ǐ: krǐːlɔ
ǔ: bʎǔʋati
ǝ: ˈmeːlǝn
ɐ: 'bɪhan, 'bi:ɐn
ɑ: lɑːn
ɒ: wɒt
ɔ: t̪ɔʰtʲ
ɘ: wɘ̟
ə: ˈfʲiəkəlʲ
ɛ: b̊ɛn
ɜ: wɜ:m
ɨ: haɨl
ɪ: kɤʎɪ
ɯ: ɯʃɡ̊ʲɪ
ɵ: ˈhɵ̀sːtrɵ
ɶ: ˈd̥ʰɶɐ̯ʌ
ʉ: gʉəl
ʊ: fʲlʲʊx
ẽ: ˈẽvn, ˈẽwn, ẽːn
ʏ: ˈsʏgna
ɤ: kɤʎɪ
ʌ: tʌŋ

b: b̊ɛn
c: ceː
d: d̊ʲeː
f: flux
g: glas
h: hu, u
j: tʲjuː
k: kɤʎɪ
l: lʲɛ
m: mad̊ʲɪ
n: b̊ɛn
p: pahtə
q: qɛ kəɾnə, ʔulʈɪ kəɾnə
r: rʲuːnak
s: ʤʲɛs
t: ˈtʃi.lɪk
v: ɫ̪ãːv
w: l̪ˠɑːvˠ, l̪ˠæːw
x: flux
z: ˈtrɛːz
ç: ˈiːçə, ˈiːhə, ˈiː
ð: ˈmɛðʊl
č: či
ł: čełk‘el
ŋ: frɑ̃ŋ-k
š: šistɐ
ǰ: mrǰiwn
ɕ: ˈpˠaːɕtʲɪ
ɖ: juːɖ
ɟ: nʲiː, nʲɪɟ
ɡ: ɡ̊ʲaɫ̪
ɣ: ruəɣ
ɥ: ˈviː, ˈɥiː
ɦ: ˈɦaːzɛt
ɧ: ɧæʈː
ɫ: ɡ̊ʲaɫ̪
ɬ: ˈɬədan
ɭ: ˈaskɛɭ
ɰ: ˈjɛɰ̃zɘ̟k
ɲ: kruɪɲ
ɳ: ˈɧæ̀ːɳa
ɸ: ɸʹið
ɹ: oaɹ
ɻ: ˈstɛɻ̊ʈʊɹ
ɽ: ɡʉːɽ, ɡʉːl
ɾ: d̊ʲiːɾʲəx
ʀ: vɛʀ
ʁ: bɐˈʁiɣɐ
ʂ: pæˈʂu:n
ʃ: ɯʃɡ̊ʲɪ
ʈ: ɧæʈː
ʋ: ˈkʋɪ̀nːə
ʍ: ʍi:
ʎ: kɤʎɪ
ʐ: ˈʐowtɘ̟
ʑ: ʑɔ
ʒ: ˈniːʒal
ʔ: teʔe, té, te
ʝ: ʝo
β: sʹi:, sʹiβʹ
δ: /čānu, kaδu/
θ: ˈkerθet
χ: ˈɛχtɣənotə
ᵲ: ɡ̊ʲaːᵲ
ṙ: sɑṙə
ṽ: ˈpreːṽ
ž: bɐžgin

ʣ: saʣɨn
ʤ: ʤʲɛs
ʥ: ʥɛɲ
ʦ: səˈmɨnʦə
ʧ: ʧe
ʨ: uˈdɛʐaʨ

ʰ: t̪ɔʰtʲ
ʱ: dʱəkəl'ɳe
ʲ: lʲɛ
ʷ: ˈdeːhoʷ, ˈdeː(h)u
ʹ: sʹi:, sʹiβʹ
ˀ: guˀl
ˈ: ˈfʲiəkəlʲ
ˌ: ˌabaˈlɑ̃mur, aˈblɑ̃mǝr, blɑ̃m
ː: koː
ˑ: piˑʊ
ˠ: bʲan̪ˠ
̀: ˈkɛ̀lɪŋg
́: wɑ́tːn̩
̂: vîː
̃: prɛ̃v, prẽw
̄: pāɳī
̆: ˈsɛmĕɛ
̊: b̊ɛn
̌: mrǎːvlja
̑: b̑ə
̜: ˈtʰvo̜ːa
̝: g̥ʁɶ̝nˀ
̞: flɔ, flɔ̞ɾ
̟: wɘ̟
̠: əunʲ, əun̠ʲ, oːn̠ʲ
̤: z̤âdi
̥: sg̥ɒwˀ
̩: 'vɪʃn̩
̪: ɡ̊ʲaɫ̪
̯: əi̯ɾʲ
̴: ˈkʲar̴st
̻: l̻ʲahən̻ˠ
͜: t͜svaĭ
͡: ˈsɪ̀t͡ʃːɑ
ᵘ: ɔːᵘt
‘: čełk‘el
’: buz’altrəs
‿: 'ʃpe‿iən
ⁿ: 'me:ⁿskə

