IPA symbol: Sample usage

ʃ: ɯʃɡ̊ʲɪ
̂: vîː
̆: ˈsɛmĕɛ
ʋ: ˈkʋɪ̀nːə
̊: b̊ɛn
ʏ: ˈsʏgna
ɘ: wɘ̟
‘: čełk‘el
̞: flɔ, flɔ̞ɾ
 : hu, u
ʣ: saʣɨn
ʧ: ʧe
(: ˈg(w)ri(z)jɛn
̪: ɡ̊ʲaɫ̪
,: hu, u
β: sʹi:, sʹiβʹ
ʷ: ˈdeːhoʷ, ˈdeː(h)u
?: o:a (?), ai
ł: čełk‘el
̌: mrǎːvlja
ɐ: 'bɪhan, 'bi:ɐn
ɔ: t̪ɔʰtʲ
X: XXX
ǝ: ˈmeːlǝn
ɜ: wɜ:m
ɤ: kɤʎɪ
ã: mãːhɪɾʲ
d: d̊ʲeː
ç: ˈiːçə, ˈiːhə, ˈiː
h: hu, u
ɦ: ˈɦaːzɛt
l: lʲɛ
p: pahtə
ó: ompʰalós
ᵲ: ɡ̊ʲaːᵲ
t: ˈtʃi.lɪk
ɨ: haɨl
x: flux
û: ʒûːt
ž: bɐžgin
́: wɑ́tːn̩
ʀ: vɛʀ
j: tʲjuː
ʈ: ɧæʈː
č: či
ʌ: tʌŋ
ɬ: ˈɬədan
̑: b̑ə
ʐ: ˈʐowtɘ̟
ʔ: teʔe, té, te
ĩ: kɐ̃ĩ
̝: g̥ʁɶ̝nˀ
̥: sg̥ɒwˀ
ʤ: ʤʲɛs
': 'plent.ɨn
ɰ: ˈjɛɰ̃zɘ̟k
̩: 'vɪʃn̩
ʨ: uˈdɛʐaʨ
ĭ: vaĭp
/: ˈbeːzã en e ˈxurves/ˈbeːzã gurˈveːzet
ʰ: t̪ɔʰtʲ
r: rʲuːnak
;: əmb, əm; amb, am; en
‿: 'ʃpe‿iən
ˀ: guˀl
ˈ: ˈfʲiəkəlʲ
ɶ: ˈd̥ʰɶɐ̯ʌ
ō: chōkir-
ˌ: ˌabaˈlɑ̃mur, aˈblɑ̃mǝr, blɑ̃m
ǎ: ˈbǎːtsiti
ː: koː
ɥ: ˈviː, ˈɥiː
ɸ: ɸʹið
ɛ: b̊ɛn
ā: pādarō
ɟ: nʲiː, nʲɪɟ
͡: ˈsɪ̀t͡ʃːɑ
ˠ: bʲan̪ˠ
c: ceː
g: glas
ǐ: krǐːlɔ
ũ: bɐʃˈtɐ̃ũ
k: kɤʎɪ
ŭ: fraŭ
ì: léì̯os
o: koː
ð: ˈmɛðʊl
s: ʤʲɛs
ô: ˈkôntaṽ, ˈkuntaṽ
w: l̪ˠɑːvˠ, l̪ˠæːw
ø: ˈløːn
ɻ: ˈstɛɻ̊ʈʊɹ
ɾ: d̊ʲiːɾʲəx
ⁿ: 'me:ⁿskə
ǔ: bʎǔʋati
ʁ: bɐˈʁiɣɐ
̀: ˈkɛ̀lɪŋg
̄: pāɳī
ʉ: gʉəl
ʍ: ʍi:
ɵ: ˈhɵ̀sːtrɵ
ʑ: ʑɔ
ṙ: sɑṙə
ʝ: ʝo
̜: ˈtʰvo̜ːa
̠: əunʲ, əun̠ʲ, oːn̠ʲ
ʥ: ʥɛɲ
̤: z̤âdi
*: *gune̞ː
.: ˈtʃi.lɪk
ʱ: dʱəkəl'ɳe
̴: ˈkʲar̴st
ʹ: sʹi:, sʹiβʹ
:: ma:, mah
ẽ: ˈẽvn, ˈẽwn, ẽːn
š: šistɐ
·: að·a:ɣəθər
χ: ˈɛχtɣənotə
ɣ: ruəɣ
ˑ: piˑʊ
ɒ: wɒt
ɖ: juːɖ
ᵘ: ɔːᵘt
͜: t͜svaĭ
á: nákti
b: b̊ɛn
ɧ: ɧæʈː
f: flux
é: teʔe, té, te
ɪ: kɤʎɪ
í: oi̯kíaː
n: b̊ɛn
ɲ: kruɪɲ
õ: kõ
v: ɫ̪ãːv
ù: entáù̯tʰa
z: ˈtrɛːz
ɫ: ɡ̊ʲaɫ̪
~: i ~ j-
̃: prɛ̃v, prẽw
ʂ: pæˈʂu:n
ɭ: ˈaskɛɭ
ʊ: fʲlʲʊx
ʎ: kɤʎɪ
ē: orpēs
ʒ: ˈniːʒal
ɯ: ɯʃɡ̊ʲɪ
’: buz’altrəs
ě: ˈtʃětiri
̟: wɘ̟
ʦ: səˈmɨnʦə
): ˈg(w)ri(z)jɛn
ī: əsī̃
-: gɑ̃n-t
ɳ: ˈɧæ̀ːɳa
̯: əi̯ɾʲ
ʲ: lʲɛ
δ: /čānu, kaδu/
θ: ˈkerθet
̻: l̻ʲahən̻ˠ
=: kʰɑni=ʋor
ŋ: frɑ̃ŋ-k
ɑ: lɑːn
ɹ: oaɹ
œ: ˈblœ̃wɛn, ˈblœ̃niɛn
ɕ: ˈpˠaːɕtʲɪ
a: ɡ̊ʲaɫ̪
ə: ˈfʲiəkəlʲ
ɡ: ɡ̊ʲaɫ̪
â: ˈprâti
e: d̊ʲeː
æ: ˈfˠæɾˠɟɪ
i: ˈfʲiəkəlʲ
ṽ: ˈpreːṽ
ê: ˈtêtɕi
m: mad̊ʲɪ
î: ˈbrîsati
q: qɛ kəɾnə, ʔulʈɪ kəɾnə
ǰ: mrǰiwn
u: flux
y: ˈryː, ˈryːz
ú: lúːɔː
ɽ: ɡʉːɽ, ɡʉːl
